........#...................#........#.............................
..#.....#...................#...X....#.............................
..#.....#...................#........#.............................
..#..S..#...................#........#...................#.........
..#.....#..................#.........#...................#.........
..#######.................#..........#...................#.........
.........................#...........#####.###############.........
........................#............#............#................
.......................#..........................#................
......................#..............#............#....############
#################....##############################................
....................#.............................#................
...................#........................##############.........
..................#.........................#......................
.................#..........................#......................
................#...........................#........#.............
.....###########............................#.........#............
..............#......##################.....#..........#...........
.............#...............#..............#...........#..........
............#................#..............#............#.........
...........#................#...............#.............#........
..........#................#........#########..............#.......
.........#................#.........#.......................#......
........#................#..........#.......#......................
.......#................#...........#.......#......................
.......#...............#............#....##############............
.......#..............#.............#....#.........................
.....................#...................#.........................
....................#....................#.........................